35
35
0
10
++++++++++S++++++++++++++++++++++++
++++++++++OOOOOOOOOOOOOOOOOOOOOOOOO
++++++++++O++++++++++++++++++O+++++
OOOOOOOOOOOOOOOOOOOOOOOOOO+++O++OOO
O+++++++++O++++++++++++++O+++O++O++
OOOOOO++++O++++++++++++++O+++O++O++
O++++O++++OOOOOOOOOOO++++O+OOO++O++
O++++O++++O+++++++++OOOO+O+++O++O++
OOO++OOOO+OOOOOO+++++++++++OOO++OOO
O+O+++++O++++++OOOOOOOOOO++O++++++O
O+OOOO++O++++++O++++++++O+++OOO+++O
O++++O++OOOOOOOO++++++++O+++O+O+++O
OOO++O++++++++++++++++++OOOOO+O+++O
++O++OOOOOOOOOOOOOOOO+++++++++OO++O
OOO+++++++++++++++++OOOOOO++++++++O
O++++++++++++++++++++++++O++OOOOOOO
+++++++++++++++++++++++++O++O++++++
OOOOOOOOOOOOOOOOOOOOOOOOOO++OOOOO++
O++++++++++++++++++++++++O++++++O++
OOOOOOO+++++++++++++++OOOOOOO+++O++
++++++++++++++++++++++O+++++OO++O++
OOOOOOOOOOOOOOOOOOOOOOO++++++O++O++
O++++++++++++++++++++++++++++O+OOOO
OOOO++++++++++++++++++++OOOOOO+O+++
+++OOOOOOOOO+++++++++++++++++++O+++
+++++O+++++OOOOOOOOOO++++++++OOO+++
+O+++OOOOO++++++O++++++++++++O+++++
+OOOOO+++O++++++OOOOOO+++++++O+++++
+++++++++++++++++++++OOOOOOOOO+++++
OOOOOOOOOOOOOOOOOOOOOO+++++++++++++
OOO++++++++++++++++++++++++++++++++
++E++++++++++++++++++++++++++++++++
+++++++++++++++++++++++++++++++++++
+++++++++++++++++++++++++++++++++++
+++++++++++++++++++++++++++++++++++