++++++++++
+     F  +
+ + + +  +
    +   ++
+ +   + ++
+ + +    +
+ +++ ++ +
+   ++ + +
+       ++
+ +     ++
+ +     ++
+ +     ++
+ +     ++
+ +     ++
+ +     ++
+ +     ++
+ +     ++
+ +     ++
+ + + + ++
+ + +    +
+ + + +  +
+ + +    +
+ + + +  +
+ + +    +
+ + + +  +
+ + +    +
+ + + + ++
+ + +    +
    +   ++
+ +   + ++
+ + +    +
+ + + ++ +
+   ++ + +
    +   ++
+ +   + ++
+ + +    +
+ +++ ++ +
+   ++   +
    +   ++
+ +   + ++
+ + +    +
+ +++ ++ +
+   ++   +
+++++++S++